0000000110000000
0000000110000000
0000011111110000
0000114444411100
0001134444444100
0014333444444110
0114433344444410
1144443334444411
1144444333444411
0114444433344110
0001144443331100
0000111444311000
0000001111110000
0000000110000000
0000000110000000
0000000110000000