0000000110000000
0000000110000000
0000011111110000
0000114444411100
0011144444444100
0014444444444110
0114444444444410
1133333333333311
1133333333333311
0114444444444110
0011144444441100
0000111444111000
0000000111000000
0000000110000000
0000000110000000
0000000110000000