0000000110000000
0000000110000000
0000011111100000
0000114334411100
0001144334444100
0014444334444110
0114444334444410
1144444334444411
1144444334444411
0114444334444110
0001144334441100
0000111334111000
0000001111000100
0000000110000000
0000000110000000
0000000110000000