0000000110000000
0000000110000000
0000011111110000
0000114334411100
0001144334444100
0014444334444110
0114443333444410
1133333443333311
1133333443333311
0114443333444110
0011144334441100
0000111334111000
0000001111100000
0000000110000000
0000000110000000
0000000110000000