0000022222200000
0000223333220000
0002233333322000
0002332222332000
0002333333332000
0002322332232000
0002333333332000
0002322332232000
0002333333332000
0002322332232000
0002333333332001
1002222332222001
1100001111000010
1111111111111110
0111111111101111
0011000110000110