0001001110001100
0011114441111100
0144444444444410
1142244444422411
1142222222222410
0144233333324410
0144233333324410
1144233333333311
1114233333333310
0114233333324410
0144233333324410
0142222222222411
0142244444422410
0144444444444410
0011111441111100
0001000110011000