0001110000011000
0011111111110110
1022222222232210
1123332333233211
0123332333233211
0123332333233200
0122322232233210
1123333333333211
0133333333333211
0122222222333210
0123333332333210
0023333332333210
0023333333333211
0022222222222210
0111111111111010
0001100000011100