0000000010000000
0000000110000000
0000001111100000
0000114444110000
0001444444441000
0014444444444100
0144444444444410
1144444444444411
0144444444444111
0014444444444100
0001144444441000
0000011444110000
0000000111000000
0000000110000000
0000000110000000
0000000010000000
