0001111111111000
0222222011222220
0233332011233320
0233333111233320
0233333111233320
0233332011333320
0222222011333320
0000000111233320
1111111110233320
0000110000233320
0222332220222220
0233333320000000
0233333320000000
0233333320000000
0222222221000000
0000000011000000