0000000000000000
0000222222222200
0000233333333200
0000233333333200
0000233333333200
0000222222332200
0000000000110000
0222222200111101
0233333201111111
0233333201100011
0233333311100001
0233333201100000
1233333201100000
1222222201100000
1100001111100000
0111111100000000