0000000110000000
0222222110000000
0233332110044400
0233333110444440
0233333110444440
0233333110444400
0233332110044000
0222222110000000
0000000110000000
0044400112222220
0444400112333320
0444440113333320
0444440113333320
0044440112333320
0004400112222220
0000000110000000