00000000000000011000000000000000
00011111111111111111111111111000
01022000000000011000000000022010
01233222222222211222222222233210
00233222222222211222222222233210
01022000000000000000000000022010
01022002220022200222002220022010
01022002220022200222002220022010
01022000000000000000000000022010
01022002200220022002200220022010
01022002200220022002200220022010
00022002200220022002200220022010
01022000000000000000000000022010
01022002220000222200002220022000
01022002220002244220002220022100
11111000000002444420000000011111
11111000000002444420000000011111
01022002220002244220002220022010
01022002220000222200002220022010
01022000000000000000000000022000
01022000222000022000022200022010
01022000222000022000022200022011
01022000000000022000000000022010
01022002200000000000000220022010
00022002200022200222000220022010
01022002200022200222000220022010
01022000000000000000000000022010
01233222222222211222222222233210
00233222222222211222222222233210
01022000000000111000000000022010
00001111111111011111110111111000
00000000000000010000000001000000