00000000000000000100000000000000
00222222220000001000000000000000
00233333320000001100000222222200
00233333320000001100000233333200
00233333331111010000000233333200
00233333320001111101000222322200
00222222220000011111110001100000
00000000000000111011111101100100
00000000000111111111111111010000
00000000001114443340041110000000
00000000111440003444444411100000
00000011144440004444444441100000
00000111444443444440044444110000
01111111444433444440004444111100
11011114444434444444004444411111
01110114444004444444444444411110
00011114440000344444400444411100
00001114444004334444400044411000
00000111444444433444400044111000
00000011144444440044444441110000
00000000114444400004444411100000
00000000011144400004444111000000
00000000000111334044411111000000
00000000010011131111111110000000
00000000000000111111011000000000
00000001111000011110000100000000
00000111111100001000000000000000
00000111111000011100000000000000
00000011100000000100000000000000
00000000000000001100000000000000
00000000000000001100000000000000
00000000000000001000000000000000