00000000000000000000000000000000
00000000000000010000000000000000
00003000000000010000000000000000
00003030000000111000000000000000
00000030000111111110000000000000
00000000001144444411100000000000
00000000011444444444411000000000
00000000114444444444441110000000
00000011334444444444444411100000
00000114333444444444444444110000
00000114434434000444444444411000
00001144444330000044444444411000
00011444444000000000444444441100
00114444440022222220044444441100
00114444400023333320004444441100
10114444400023333320003333331010
01114444440023333320003333331100
00114444440022333220004444441100
00011444444000000000044444441100
00011444444440000004444444411000
00001144444444000444444444411000
00001144444444444444444444110000
00000114444444444444444441100000
00000111444444444444444411000000
00001111114444444444444110000000
00001100011444444444411100000000
00223322001114444441110000000000
00233332000011111111000000000000
00233332000000111110000000000000
00233332000001111000000000000000
00223322000111010000000000000000
00001101101100000000000000000000