0000000000000000000000000000000000000000000000000000000000000000
0000000000000000000000000000000000000000000000000000000000000000
0000002222222222222000000000000000000222222222222222222200000000
0000002333333333332000000000000000000233333333233333333200000000
0000002333333333332000000000000000000233333333233333333200000000
0000002333333333332222222222200000000233333333233333333200000000
0000002333333333333333333333200000000233333333233333333200000000
0000002333333333333333333333200000000233333333233333333200000000
0000002333333333333333333333200000000233333333233333333200000000
0000002333333333333333333333200000000233333333233333333200000000
0000002333333333333333333333200000000222244222222222442200000000
0000002222224422222222222222200000000000011000000000110000000000
0000000000001100000000000000000011110000011000000000110000000000
0000000000001100000000000000000112211000011000000000110000000000
0000000100111111111111111111111124421111111111111111111110000000
0000000011111111111111111111111124421111111111111111110000000000
0000000000000000000000000000000112211000000000000000001000000000
0000000000000000000000000000000011110000000000000000000000000000
0000000000000000000000000000000011110000000000000000000000000000
0000000000000000000000000000000011110000000000000000000000000000
0000000000000000000000000000000011110000000000000000000000000000
0000000000000000000000000000000011110000000000000000000000000000
0000000000000000000000000000000011110000000000000000000000000000
0000000000000000000000000000000011110000000000000000000000000000
0000000000000000000000000000000011111000000000000000010000000000
0001000101111111111111111111111111111111111111111111111011000000
0000001110111111111111111111111111111111111111111111000100001000
0000000000001110000000000000111111110000000000000000000000000000
0000000000000110000000000000000000000000000000000004440000000000
0000000000001100002222222222200000222222222220000044444400000000
0000000000001100002333333333200000233333333320004444444444000000
0000000000001100002333333333200000233333333320044444444444440000
0000000000001100002333333333222222233333333320044444444444444000
0000000000011100004333333333333333333333333320004444444444444400
0000000000000000004333333333333333333333333320004444444444444000
0000000000000000002333333333333333333333333320000444444444440000
0000000000000000002333333333333333333333333320000044444444400000
0000000000000000002222222222222222233333333320000004444444000000
0000000000000000000000000000000000233333333320000000444440000000
0000000000000000000000000000000000233333333320000000004400000000
0000000000000000000000000000000000222222222220000000000000000000
0000000000000000000000000000000000000000000000000000000000000000
0000000000000000000000000000000000000000000000000000000000000000
0000000000000000000000000000000000000000000000000000000000000000
0000000000000000000000000000000000000000000000000000000000000000
0000000000000000000000000000000000000000000000000000000000000000
0000000000000000000000000000000000000000000000000000000000000000
0000000000000000000000000000000000000000000000000000000000000000
0000000000000000000000000000000000000000000000000000000000000000
0000000000000000000000000000000000000000000000000000000000000000
0000000000000000000000000000000000000000000000000000000000000000
0000000000000000000000000000000000000000000000000000000000000000
0000000000000000000000000000000000000000000000000000000000000000
0000000000000000000000000000000000000000000000000000000000000000
0000000000000000000000000000000000000000000000000000000000000000
0000000000000000000000000000000000000000000000000000000000000000
0000000000000000000000000000000000000000000000000000000000000000
0000000000000000000000000000000000000000000000000000000000000000
0000000000000000000000000000000000000000000000000000000000000000
0000000000000000000000000000000000000000000000000000000000000000
0000000000000000000000000000000000000000000000000000000000000000
0000000000000000000000000000000000000000000000000000000000000000
0000000000000000000000000000000000000000000000000000000000000000
0000000000000000000000000000000000000000000000000000000000000000