0000000000000000000000000000000000000000000000000000000000000000
0000000000000010000000000000000000000000000000000100000000000000
0022200000000011000000000000000000000000000000011000000000022200
0022222222222111122222222222222222222222222222211112222222222200
0022200000000111100000000000000000000000000000011100000000022200
0002002222222011000004444400000222222222222000011000000220002000
0002002333332011000044444444000233333333332000011111112442002000
0002002333333111000004444000000233333333333111111111112442002000
0002002333333111000000440000000233333333333111111000000220002000
0002002333332011000000000000000233333333332000011000000000002000
0002002222222011000000000000000222222222222000011000000000002000
0002000000000000000000000000000000000000000000011000000000002000
011100000000
001100000000
0011
0101
0002
0002
0002
0002
0002
0002
0002
0002
0002
0002
0002
0002
0002
0002
0002
0002
0002
0002
0002
0002
0002
0002
0002
0002
0002
0002
0002
0002
0002
0002
0002
0002
0002
0002
0002
0002
0002
0002
0002
0002
0002
0002
0002
0022200000000000000000000000000000000000000000000000000000222200
0022222222222222222222222222222222222222222222222222222222222200
0022200000000000000000000000000000000000000000000000000000022200
0000000000000000000000000000000000000000000000000000000000000000
0000000000000000000000000000000000000000000000000000000000000000