11111110
12222220
12333320
12333330
12333331
12333320
12222220
11111110