00011000
00044000
00444440
14444441
14444440
00444440
00044400
00010000