00011000
00001000
10011000
11111011
00011111
00011000
00010000
00010000