00001000
00001000
00011000
11110011
00111110
00101000
00111000
00001000