00001000
00011000
01011000
11111111
10111101
00011000
00011000
00001000