00011000
00001000
00001000
10001111
11111000
00010000
00010000
00011000