00000000
00101000
00011100
00111000
00011000
00100000
00000100
00000000