00001000
00011000
00010000
11111101
00111111
00011000
00010000
00001000