00011000
00101000
00011100
00110101
11111111
10111010
00110000
00011000