00011000
00011200
10012421
11111201
11201111
02421000
00201000
00011000