00010000
00111000
01122110
01244211
11244211
00122110
00111100
00010000