0000000000000000000000000000000000000000000000001000000000000000
0000000000000010000000000000000000000000000000000100000000000000
0022220000000011000000000000000000000000000000001100000000222200
0022222222222211222222222222222222222222222222221122222222222200
0022333333333311333333333333333333333333333333331133333333332200
0022322222222211222222222222222222222222222222221122222222232200
0002320000000011000000000000000000000000000000001100000000232000
0002320022222011000444400002222222222222222222201100000000232000
0002320023332011004444444002333333233333323333201100002200232000
0002320023333111000444444002333333233333333333311101124420232000
0002320023333111000444440002333333233333323333201111124420232000
0002320023332011000004400002223322222222222222201100002200232000
0002320022222011000000000000001100000000000000001000000000232000
0002320000000011100000000000000100000000000000001100001110232000
0101111111111111111111111111111111111111111111111111111111111110
0011111111111111111111111111111111111111111111111111111111111101
0002320000000000000000110000000000000000000000000000000000232000
0002320222222222222200110000200000000000000002000000000000232000
0002320233323332333200110002322222222222222223200000000000232000
0002320233323332333200110000200000000000000002000000000000232000
0002320233323332333200110000200000220022000002000000000000232000
0002320223222322232200110000200000220022000002000000000000232000
0002320233333333333200110000202220220022022202000000000000232000
0002320233333333333200110000202220000000022202000000000000232000
0002320222222233333311110000200000002200000002000000000000232000
0002320233333233333311110000202220002200022202000000000000232000
0002320233333233333200000000202220002200022202000000000000232000
0002320233333333333200000000200000000000000002000000000000232000
0002320222222222222200000002322222200002222223200000000000000000
0002320000000000000000000000200000000000000002000000000000000000