000000000000000000000000000000000000000000000000000000000000000000
000000000000000000000000000000000000000000000000000000000000000000
000011111111111111111111111110000000011111111111111111111111110000
000010000000000000000000000010000000010000000000000000000000010000
000010000000001111000000000010000000010000000001111000000000010000
000010000001111111111000000010000000010000001111111111000000010000
000010000111111111111110000010000000010000111111111111110000010000
000010000333333333333330000010000000010000333333333333330000010000
000010000334444333444330000010000000010000334444333444330000010000
000010000334444333444330000010000000010000334444333444330000010000
000010000333333333333330000010000000010000333333333333330000010000
000010000333333333333330000010000000010000333333333333330000010000
000000000000002222200000000000000000000000000002222200000000000000
000000000000002222200000000000000000000000000002222200000000000000
222222222222222222222222222222222222222222222222222222222222222222
222222222222222222222222222222222222222222222222222222222222222222
222222222222222222222222222222222222222222222222222222222222222222
000000000000000000000000000000000000000000000000000000000000000000