22222222222222222222222222222222222222222222222222222222222222222222222222222
22222222222222222222222222222222222222222222222222222222222222222222222222222
22222222222222222222222222222222222222222222222222222222222222222222222222222
22222222222222222222222223333333333333333333322222222222222222222222222222222
22222222222222222222222332222222223322222222233222222222222222222222222222222
22222222222222222222233222222222233332222222222332222222222222222222222222222
22222222222222222223322222222222332233222222222223322222222222222222222222222
22222222222222222332222222222223322223322222222222233222222222222222222222222
22222222222222233333333333333333333333333333333333333332222222222222222222222
22222222222222332222233322222332222222233222223332222233222222222222222222222
22222222222222332222222233323322222222223323332222222233222222222222222222222
22222222222223322222222222233322222222223332222222222223322222222222222222222
22222222222223322222222222332233322223332233222222222223322222222222222222222
22222222222222332222222223322222233332222223322222222233222222222222222222222
22222222222222233222222233222223332233322222332222222332222222222222222222222
22222222222222222332222332223332222222233322233222233222222222222222222222222
22222222222222222233223323332222222222222233323322332222222222222222222222222
22222222222222222223333332222222222222222222233333322222222222222222222222222
22222222222222222222233222222222222222222222222332222222222222222222222222222
22222222222222222222222332222222222222222222233222222222222222222222222222222
22222222222222222222222223333333333333333333222222222222222222222222222222222
22222222222222222222222222222222222222222222222222222222222222222222222222222
22222222222222222222222222222222222222222222222222222222222222222222222222222
22222222222222222222222222222222222222222222222222222222222222222222222222222
22222222222222222222222222222222222222222222222222222222222222222222222222222
22222222222222222222222222222222222222222222222222222222222222222222222222222
22222222222222222222222222222222222222222222222222222222222222222222222222222
22222222222222222222222222222222222222222222222222222222222222222222222222222
22222222222222222222222222222222222222222222222222222222222222222222222222222
22222222222222222222222222222222222222222222222222222222222222222222222222222
22222222222222222222222222222222222222222222222222222222222222222222222222222
22222222222222222222222222222222222222222222222222222222222222222222222222222
22222222222222222222222222222222222222222222222222222222222222222222222222222
22222222222222222222222222222222222222222222222222222222222222222222222222222
22222222222222222222222222222222222222222222222222222222222222222222222222222
22222222222222222222222222222222222222222222222222222222222222222222222222222
22222222222222222222222222222222222222222222222222222222222222222222222222222
22222222222222222222222222222222222222222222222222222222222222222222222222222
22222222222222222222222222222222222222222222222222222222222222222222222222222
22222222222222222222222222222222222222222222222222222222222222222222222222222
22222222222222222222222222222222222222222222222222222222222222222222222222222
22222222222222222222222222222222222222222222222222222222222222222222222222222
22222222222222222222222222222222222222222222222222222222222222222222222222222
22222222222222222222222222222222222222222222222222222222222222222222222222222
22222222222222222222222222222222222222222222222222222222222222222222222222222
22222222222222222222222222222222222222222222222222222222222222222222222222222