222222222222222222222
222222233333332222222
222223332232233322222
222233222323222332222
222332222323222233222
223322222323222223322
223222223222322222322
233333333333333333332
232322223222322223232
232233232222232332232
232222332222233222232
232222233222332222232
232222322323223222232
233222322333223222332
223223223222322322322
223323332222233323322
222333222222222333222
222233222222222332222
222223332222233322222
222222233333332222222
222222222222222222222
